<?xml version="1.0" encoding="UTF-8" standalone="no"?>
<keyboard id = "test">
	<pane   id="base keys"
		filename="test.svg"
		backgroundRed = "0"
		backgroundGreen = "1"
		backgroundAlpha = "0.3"

		>
		<key 
			id="0"
			sticky = "false"
			label = '0'
			shift_label = ')'
			char='0'>
		</key>
		
		<key 
			id="1"
			sticky = "false"
			label = '1'
			shift_label = '!'
			char="1">
		</key>
		
		<key 
			id="2"
			sticky = "false"
			label = '2'
			shift_label = '"'
			char="2">

		</key>
		
		<key 
			id="3"
			sticky = "false"
			label = '3'
			shift_label = '£'
			char="3">
		</key>
		
		<key 
			id="4"
			sticky = "false"
			label = '4'
			shift_label = '$'
			char="4">
		</key>
		
		<key 
			id="5"
			sticky = "false"
			label = '5'
			shift_label = '%'
			char="5">
		</key>

		<key 
			id="6"
			sticky = "false"
			label = '6'
			shift_label = '^'
			char="6">
		</key>

		<key 
			id="7"
			sticky = "false"
			label = '7'
			shift_label = '&amp;'
			char="7">
		</key>

		<key 
			id="8"
			sticky = "false"
			label = '8'
			shift_label = '*'
			char="8">
		</key>

		<key 
			id="9"
			sticky = "false"
			label = '9'
			shift_label = '('
			char="9">
		</key>

		<key 
			id="return"
			sticky = "false"
			label = 'return'
			keysym="65293">
		</key>
	</pane>
		
	<pane   id="second pane"
	filename="./testp2.svg"
	backgroundRed = "0"
	backgroundGreen = "1"
	backgroundAlpha = "0.8">
		
		<key 
			id="blob"
			sticky = "false"
			label = 'blob'
			font_offset_x = "10"
			font_offset_y = "10"
			shift_label = '{'
			char='b'>
		</key>
		
		<key 
			id="poly"
			sticky = "false"
			font_offset_x = "35"
			font_offset_y = "5"
			label = 'poly'
			shift_label = '{'
			char='['>
		</key>
		
		<key 
			id="left_square_bracket"
			sticky = "false"
			label = '['
			shift_label = '{'
			char='['>
		</key>
		
		<key 
			id="right_square_bracket"
			sticky = "false"
			label = ']'
			shift_label = '}'
			char="]">
		</key>
		
		<key 
			id="semicolon"
			sticky = "false"
			label = ';'
			shift_label = ':'
			char=";">
		</key>
		
		<key 
			id="apostrophe"
			sticky = "false"
			label = "'"
			shift_label = '@'
			char="'">
		</key>
		
		
		<key 
			id="hash"
			sticky = "false"
			label = '#'
			shift_label = '~'
			char="#">
		</key>
		
		<key 
			id="comma"
			sticky = "false"
			label = ","
			shift_label = '&lt;'
			char=",">
		</key>
		
		<key 
			id="forward_slash"
			sticky = "false"
			label = '/'
			shift_label = '?'
			char="/">
		</key>

		<key
			id="full_stop"
			sticky = "false"
			label = "."
			shift_label = "&gt;"
			char=".">
		</key>

		


	</pane>

	<pane   id="third pane"
	filename="./testp3.svg"
	backgroundRed = "0"
	backgroundBlue = "1"
	backgroundGreen = "1"
	backgroundAlpha = "0.8">
		<key 
			id="insert"
			sticky = "false"
			label = 'insert'
			keysym='65438'>
		</key>
		
		<key 
			id="home"
			sticky = "false"
			label = 'home'
			keysym="65360">
		</key>
		
		<key 
			id="delete"
			sticky = "false"
			label = 'delete'
			press="delete">
		</key>
		
		<key 
			id="page_up"
			sticky = "false"
			label = "Page up"
			press="page_up">
		</key>
		
		<key 
			id="end"
			sticky = "false"
			label = 'end'
			press="end">
		</key>
		
		<key 
			id="page_down"
			sticky = "false"
			label = "Page down"
			press="page_down">
		</key>


	</pane>
	
	<key 
		id="key0"
		sticky = "false"
		label = 'q'
		cap_label = 'Q'
		char='q'>
	</key>
	
	<key 
		id="key1"
		sticky = "false"
		label = 'w'
                cap_label = 'W'
		char="w">
	</key>
	
	<key 
		id="key2"
		sticky = "false"
		label = 'e'
		cap_label = 'E'
		char="e">
	</key>
	
	<key 
		id="key3"
		sticky = "false"
		label = 'r'
		cap_label = 'R'
		char="r">
	</key>
	
	<key 
		id="key4"
		sticky = "false"
		label = 't'
		cap_label = 'T'
		char="t">
	</key>
	
	<key 
		id="key5"
		sticky = "false"
		label = 'y'
		cap_label = 'Y'
		char="y">
	</key>

	<key 
		id="key6"
		sticky = "false"
		label = 'u'
		cap_label = 'U'
		char="u">
	</key>

	<key 
		id="key7"
		sticky = "false"
		label = 'i'
		cap_label = 'I'
		char="i">
	</key>

	<key 
		id="key8"
		sticky = "false"
		label = 'o'
		cap_label = 'O'
		char="o">
	</key>

	<key 
		id="key9"
		sticky = "false"
		label = 'p'
		cap_label = 'P'
		char="p">
	</key>
	
	<key 
		id="key10"
		sticky = "false"
		label = 'a'
		cap_label = 'A'
		char="a">
	</key>

	<key 
		id="key11"
		sticky = "false"
		label = 's'
		cap_label = 'S'
		char="s">
	</key>

	<key 
		id="key12"
		sticky = "false"
		label = 'd'
		cap_label = 'D'
		char="d">
	</key>

	<key 
		id="key13"
		sticky = "false"
		label = 'f'
		cap_label = 'F'
		char="f">
	</key>

	<key 
		id="key14"
		sticky = "false"
		label = 'g'
		cap_label = 'G'
		char="g">
	</key>

	<key 
		id="key15"
		sticky = "false"
		label = 'h'
		cap_label = 'H'
		char="h">
	</key>

	<key 
		id="key16"
		sticky = "false"
		label = 'j'
		cap_label = 'J'
		char="j">
	</key>

	<key 
		id="key17"
		sticky = "false"
		label = 'k'
		cap_label = 'K'
		char="k">
	</key>

	<key 
		id="key18"
		sticky = "false"
		label = 'l'
		cap_label = 'L'
		char="l">
	</key>

	<key 
		id="key19"
		sticky = "false"
		label = 'z'
		cap_label = 'Z'
		char="z">
	</key>

	<key 
		id="key20"
		sticky = "false"
		label = 'x'
		cap_label = 'X'
		char="x">
	</key>

	<key 
		id="key21"
		sticky = "false"
		label = 'c'
		cap_label = 'C'
		char="c">
	</key>

	<key 
		id="key22"
		sticky = "false"
		label = 'v'
		cap_label = 'V'
		char="v">
	</key>

	<key 
		id="key23"
		sticky = "false"
		label = 'b'
		cap_label = 'B'
		char="b">
	</key>

	<key 
		id="key24"
		sticky = "false"
		label = 'n'
		cap_label = 'N'
		char="n">
	</key>

	<key 
		id="key25"
		sticky = "false"
		label = 'm'
		cap_label = 'M'
		char="m">
	</key>

	<key 
		id="key26"
		sticky = "true"
		modifier = "shift"
		label = '⇧'
		>
	</key>

	<key 
		id="key27"
		sticky = "false"
		label = 'space'
		press="space">
	</key>
	<key 
		id="backspace"
		sticky = "false"
		label = "⇦"
		keysym = "65288" >
	</key>
	<key 
		id="caps"
		sticky = "true"
		modifier = "caps"
		label = 'Caps Lock'
		>
	</key>
	
	
	
	



</keyboard>
